0000010000000000
1101011101111100
0001000101010100
0111110111010001
0001000000011100
0101110110110000
0100010100010111
0111011111010000
0001000001010100
1101111101011100
0000010101000000
0010010001000010