0000010000000000
0101011111011100
0101000001010000
0101111101110110
0100010100000000
0111000111011101
0100010000000100
1101110111110110
0001000001010010
0111010101011010
0010000101010010
0000010100011000
