0000000000000000
0111101111111110
0000000100000100
0111011111010101
0100010001010100
0101010101010110
0101000100010000
0101010111111101
0001010000010100
1101011101010110
0001000101000000
0100000101001010
