0001000101000000
1101011101111110
0001000101000100
0111011101010101
0100000000010000
0111111101111110
0101000100010100
0101010111010101
0001010000010100
0101111101110111
0100010000010000
0101000101000100