0000000101000000
1101011101111100
0000000101000110
0111011101010100
0100000000010000
0111011101111110
0101000100000100
0100010111010101
0001010000010100
0101111101110101
0100010000010000
0101000101000100
