0100000100000000
0101111111110110
0100000000000100
0111111111111101
0000000000000100
0111110111110110
0100010100000100
0111010111111101
0100010000000100
0101011111010110
0101000001010000
0001000001000000
